111111111111111111
1000C0000100011011
110010000C00010101
100110101C000C0001
1100C001CC000C0111
1C01P0C00CC00000E1
111111111111111111