111111111111
1E10C00100C1
1P0110101C01
1100C001CC01
1C0100C00CC1
111111111111